[console_scripts]
statick = statick_tool.statick:main

[statick_tool.plugins.discovery]
c = statick_tool.plugins.discovery.c:CDiscoveryPlugin
cmake = statick_tool.plugins.discovery.cmake:CMakeDiscoveryPlugin
groovy = statick_tool.plugins.discovery.groovy:GroovyDiscoveryPlugin
java = statick_tool.plugins.discovery.java:JavaDiscoveryPlugin
maven = statick_tool.plugins.discovery.maven:MavenDiscoveryPlugin
perl = statick_tool.plugins.discovery.perl:PerlDiscoveryPlugin
python = statick_tool.plugins.discovery.python:PythonDiscoveryPlugin
ros = statick_tool.plugins.discovery.ros:RosDiscoveryPlugin
shell = statick_tool.plugins.discovery.shell:ShellDiscoveryPlugin
xml = statick_tool.plugins.discovery.xml:XMLDiscoveryPlugin
yaml = statick_tool.plugins.discovery.yaml:YAMLDiscoveryPlugin

[statick_tool.plugins.reporting]
code_climate = statick_tool.plugins.reporting.code_climate:CodeClimateReportingPlugin
do_nothing = statick_tool.plugins.reporting.do_nothing:DoNothingReportingPlugin
json = statick_tool.plugins.reporting.json:JsonReportingPlugin
print_to_console = statick_tool.plugins.reporting.print_to_console:PrintToConsoleReportingPlugin
write_jenkins_warnings_ng = statick_tool.plugins.reporting.write_jenkins_warnings_ng:WriteJenkinsWarningsNGReportingPlugin

[statick_tool.plugins.tool]
bandit = statick_tool.plugins.tool.bandit:BanditToolPlugin
black = statick_tool.plugins.tool.black:BlackToolPlugin
catkin_lint = statick_tool.plugins.tool.catkin_lint:CatkinLintToolPlugin
cccc = statick_tool.plugins.tool.cccc:CCCCToolPlugin
clang-format = statick_tool.plugins.tool.clang_format:ClangFormatToolPlugin
clang-tidy = statick_tool.plugins.tool.clang_tidy:ClangTidyToolPlugin
cmakelint = statick_tool.plugins.tool.cmakelint:CMakelintToolPlugin
cppcheck = statick_tool.plugins.tool.cppcheck:CppcheckToolPlugin
cpplint = statick_tool.plugins.tool.cpplint:CpplintToolPlugin
do_nothing = statick_tool.plugins.tool.do_nothing:DoNothingToolPlugin
docformatter = statick_tool.plugins.tool.docformatter:DocformatterToolPlugin
flawfinder = statick_tool.plugins.tool.flawfinder:FlawfinderToolPlugin
groovylint = statick_tool.plugins.tool.groovylint:GroovyLintToolPlugin
isort = statick_tool.plugins.tool.isort:IsortToolPlugin
lizard = statick_tool.plugins.tool.lizard:LizardToolPlugin
make = statick_tool.plugins.tool.make:MakeToolPlugin
mypy = statick_tool.plugins.tool.mypy:MypyToolPlugin
perlcritic = statick_tool.plugins.tool.perlcritic:PerlCriticToolPlugin
pycodestyle = statick_tool.plugins.tool.pycodestyle:PycodestyleToolPlugin
pydocstyle = statick_tool.plugins.tool.pydocstyle:PydocstyleToolPlugin
pyflakes = statick_tool.plugins.tool.pyflakes:PyflakesToolPlugin
pylint = statick_tool.plugins.tool.pylint:PylintToolPlugin
ruff = statick_tool.plugins.tool.ruff:RuffToolPlugin
shellcheck = statick_tool.plugins.tool.shellcheck:ShellcheckToolPlugin
spotbugs = statick_tool.plugins.tool.spotbugs:SpotbugsToolPlugin
uncrustify = statick_tool.plugins.tool.uncrustify:UncrustifyToolPlugin
xmllint = statick_tool.plugins.tool.xmllint:XmllintToolPlugin
yamllint = statick_tool.plugins.tool.yamllint:YamllintToolPlugin
